4 4 4 0 0 0 0 0 0 0
s 4 4 0 0 0 0 0 0 2
s 4 4 0 0 d 0 0 2 2
4 s 4 0 0 7 6 0 2 2
4 s 0 0 7 0 6 0 2 2
4 4 C 0 7 0 0 g 2 2
4 t 0 7 0 0 7 0 2 h
4 t 0 7 0 0 7 0 2 h
B 0 7 0 0 7 0 2 h 2
4 6 7 0 0 7 0 2 h 2
0 e 0 0 f 0 2 h 2 2
0 0 0 0 0 6 2 h 2 2
0 0 0 0 0 6 h 2 2 2
0 0 0 0 0 0 p 2 2 2
0 0 0 0 0 0 2 2 2 2